##################################################
# #                               #              #
# #####                           #              #
#                                 #              #
#####                             #              #
#                                 #              #
#                                 #              #
#                                 #              #
#                                                #
#                                                #
#                                                #
#                                                #
#                                                #
#                                                #
#                                                #
#                                                #
#                                                #
#                                                #
#    #########################    ################
#    #                                           #
#    #                                           #
#    #                                           #
#    #                                           #
##################################################