##################################################
# #           #                   #              #
# #####       #                   #              #
#  $          $                   #              #
#####                             #              #
#                                 #              #
#                                 #              #
#                                 #            ###
#                                                #
#             ####                #              #
#                                 #              #
#           ##################### #              #
#           #####                 #              #
#           #####                 #              #
#           #   #                 #              #
#           #   #                 #              #
#           #  $                  #              #
#           # $              #    #              #
#    #########################   #################
#    #                                           #
#    #                           #               #
#    #                           #$              #
#  $ #                       $   #               #
##################################################